[0, 0, 0, 0, 0, 0, 0, 0, 0, 0, 0, '\n',
 0, 0, 0, 0, 0, 0, 0, 0, 0, 0, 0, '\n',
 0, 0, 0, 0, 0, 0, 0, 0, 0, 0, 0, '\n',
 0, 0, 0, 0, 0, 0, 0, 0, 0, 0, 0, '\n',
 0, 0, 0, 0, 0, 0, 0, 0, 0, 0, 0, '\n',
 0, 0, 0, 0, 0, 0, 0, 0, 0, 0, 0, '\n',
 0, 0, 1, 0, 0, 0, 0, 0, 0, 0, 0, '\n',
 0, 0, 1, 0, 0, 0, 0, 0, 0, 0, 0, '\n',
 0, 0, 1, 0, 0, 0, 0, 0, 0, 0, 0, '\n',
 1, 1, 1, 0, 0, 0, 0, 0, 0, 0, 1, '\n']
 
# No Check Needed because they will end up getting checked from the other coordinates
8, 9, 10, 19, 20, 21, 30, 31, 32, 41, 42, 43, 52, 53, 54, 63, 64, 65, 74, 75, 76, 85, 86, 87, 96, 97, 98, 107, 108, 109

 
 